x,x,x,x,x,x,x,x,x,x,x,x,x,x
x,x,x,x,x,x,x,x,x,x,x,x,x,x
2,2,x,x,x,x,1,1,x,x,x,x,2,2
x,x,x,x,x,2,2,2,2,x,x,x,x,x
x,x,x,3,3,3,3,3,3,3,x,x,x,x
x,x,x,4,4,4,x,x,4,4,4,x,x,x
x,x,1,1,1,1,x,x,1,1,1,1,x,x
x,x,x,6,6,6,x,x,6,6,6,x,x,x
x,x,x,x,7,7,7,7,7,7,x,x,x,x
x,x,x,x,x,5,5,5,5,x,x,x,x,x
2,2,x,x,x,x,1,1,x,x,x,x,2,2
x,x,x,x,x,x,x,x,x,x,x,x,x,x
x,x,x,x,6,6,6,6,6,6,x,x,x,x
x,x,x,x,6,6,6,6,6,6,x,x,x,x