x,x,x,x,x,x,x,x,x,x,x,x,x,x
x,x,x,x,x,x,x,x,x,x,x,x,x,x
x,8,8,8,8,8,8,8,8,8,8,8,8,x
x,2,2,2,2,2,2,2,2,2,2,2,2,x
x,3,3,3,3,3,3,3,3,3,3,3,3,x
x,x,x,x,x,x,x,x,x,x,x,x,x,x
x,x,x,x,x,x,x,x,x,x,x,x,x,x
x,4,4,4,4,4,4,4,4,4,4,4,4,x
x,8,8,8,8,8,8,8,8,8,8,8,8,x
x,6,6,6,6,6,6,6,6,6,6,6,6,x
x,x,x,x,x,x,x,x,x,x,x,x,x,x
x,x,x,x,x,x,x,x,x,x,x,x,x,x
x,7,7,7,7,7,7,7,7,7,7,7,7,x
x,x,x,x,x,x,x,x,x,x,x,x,x,x
x,x,x,x,x,x,x,x,x,x,x,x,x,x
x,x,x,x,x,x,x,x,x,x,x,x,x,x
x,6,6,6,6,6,6,6,6,x,x,x,x,x